0 1 2 2 2 2 2 2 2 2 2 2 2 2 2 2 2 2 2 2 2 2 2 2 3
4 5 5 5 5 5 5 5 5 5 5 5 5 5 5 5 5 5 5 5 5 5 5 5 6
7 5 5 5 5 5 5 5 5 5 5 5 5 5 5 5 5 5 5 5 5 5 5 5 6
7 5 5 5 5 5 5 5 5 5 5 5 5 5 5 5 5 5 5 5 5 5 5 5 6
8 2 2 2 2 2 2 2 2 2 2 2 2 2 2 2 2 2 2 8 5 5 5 5 6
7 5 5 5 5 5 5 5 5 5 5 5 5 5 5 5 5 5 5 5 5 5 5 5 6
7 5 5 5 5 5 5 5 5 5 5 5 5 5 5 5 5 5 5 5 5 5 5 5 6
7 5 5 5 5 5 5 5 5 5 5 5 5 5 5 5 5 5 5 5 5 5 5 5 6
7 5 5 5 5 5 5 5 5 10 2 2 2 2 2 2 8 2 2 2 2 2 2 2 8
7 5 5 5 5 5 5 5 5 7 5 5 5 5 5 5 7 5 5 5 5 5 5 5 6
7 5 5 5 5 5 5 5 5 7 5 5 5 5 5 5 7 5 5 5 5 5 5 5 6
7 5 5 5 5 5 5 5 5 7 5 5 5 5 5 5 7 5 5 5 5 5 5 5 6
7 5 5 5 5 5 5 5 5 7 5 5 5 5 5 5 7 5 5 5 5 5 5 5 6
7 5 5 5 5 5 5 5 5 8 5 5 5 5 5 5 8 5 5 5 5 5 5 5 6
7 5 5 5 5 5 5 5 5 5 5 5 5 5 5 5 5 5 5 5 5 5 5 5 6
7 5 5 5 5 5 5 5 5 5 5 5 5 5 5 5 5 5 5 5 5 5 5 5 6
7 5 5 5 5 5 5 5 5 5 5 5 5 5 5 5 5 5 5 5 5 5 5 5 6
7 5 5 5 5 5 5 5 5 8 5 5 5 5 5 5 8 5 5 5 5 5 5 5 6
7 5 5 5 5 5 5 5 5 7 5 5 5 5 5 5 7 5 5 5 5 5 5 5 6
9 2 2 2 2 2 2 2 2 8 2 2 2 2 2 2 8 2 2 3 5 5 5 5 11

